..........W.........
....W....###........
-------...1.........
..........W........X
.-...W.....W...-.###
-------...W....-....
..........W.....-...
...-.W.....W........
-------...W..W.....-
..........W..-------
....-W.....W........
-------...W..W......
..........W..-------
..........W.........
..@@@@@@@@@@@@@@@@..

