....................
...W.W.W.......W.W.W
@@@@@@@@............
.............---....
..........-.........
..---...---.......X.
..---...........----
..---...............
..---.-------.......
..---...........W...
..---..........@@...
W..-..........W.....
@@@@@.........@@....
.1..............W...
#######......@@@@@..


