....................
....................
..........X.........
.......######.......
..W..............W..
####..W.W.W.W....###
.......W.W.W.W......
......@@@@@@@@......
....-...........-...
....................
W..W............W.W.
####............####
....................
.1..................
#######..***********
####################
