....................
.....W..............
...@@@....--........
...W..........WWW...
...@@...--....WWW...
..........1...WWW...
...@@....@@...WWW...
....W.........@@@...
............. WWW...
...@@..--...--WWW...
..........-...WWW...
r.........----WWW...
........--....WWW...
.X......--....WWW...
######..###...@@@...
####################
